#######    ##########
#h____#    #________#
#_____######________#
#___________________#
#_____######________#
#######    ######_###
                #_#
             ####_#######
             #__________#
             #__________#
             #__________#
             ############