#######    ##########
#h____#    #_______m#
#____m######________#
#___________________#
#_____######__m_____#
#######    ######_###
                #_#
             ####_#######
             #__m_______#
             #_________m#
             #__________#
             ############